NO      ./textures/putin.xpm
SO      ./textures/psycho.xpm
EA      ./textures/doom.xpm
WE      ./textures/hitler.xpm


C       99,89,133
F       24,18,43

11111111111111111111111111
10000000000000000000000001
10000000000000000000000001
10000000000000000000000001
10000000000000000000000001
10000000000000000000000001
1000000000000000W000000001
10000000000000000000000001
10000000000000000000000001
10000000000000000000000001
10000000000000000000000001
10000000000000000000000001
11111111111111111111111111
